P=(1,1)
C=(7,1)
9x30
██████████████████████████████
█☺···························█
████████████████████████████·█
█····························█
█·████████████████████████████
█····························█
████████████████████████████·█
█ϖ···························█
██████████████████████████████