P=(3,9)
C=(5,1)
7x20
████████████████████
█··············█···█
█·██·██·██·██·██·█·█
█········☺·······█·█
██████████████████·█
█ϖ·················█
████████████████████