P=(5,1)
C=(5,5)
7x20
████████████████████
█··············█···█
█·██·██·██·██·██·█·█
█················█·█
██████████████████·█
█☺···ϖ·············█
████████████████████