P=(7,1)
C=(1,1)
9x30
██████████████████████████████
█ϖ···························█
███·███·████·███████·███·███·█
█····························█
█·█·████████·███████·███████·█
█····························█
███·████·███████·███████·███·█
█☺···························█
██████████████████████████████