████████████████████
█··············█···█
█·██·██·██·██·██·█·█
█················█·█
██████████████████·█
█··················█
████████████████████